0 0 0 0 3 0 0 0 0 0
0 4 2 0 3 0 2 2 0 0
2 2 2 0 0 0 2 0 0 0
0 0 0 3 3 3 3 1 3 3
0 0 0 0 3 0 0 0 0 0
0 0 0 0 3 0 2 0 0 0
0 0 0 0 3 0 2 2 2 0
0 0 0 0 3 0 2 0 0 0
0 51 0 0 3 0 2 0 0 0
0 0 0 0 0 0 0 2 0 4