0 0 0 0 0 0 0 2 2 2 
3 4 2 0 1 0 0 0 4 0 
2 2 2 0 0 0 0 0 3 0 
0 0 0 0 0 0 0 2 0 0 
0 0 0 0 1 0 0 0 0 0 
3 0 2 3 53 2 3 2 0 3 
3 0 2 0 2 0 0 2 0 3 
3 4 2 0 0 0 0 2 4 3 
3 0 2 0 0 0 0 2 0 3
0 0 0 0 0 0 0 0 0 0